111111111111111111111
100P00000000000000001
11110C000000111111111
10C000000000000000E01
111111111111111111111