111111111111111111111
100P00000C00000001111
11110C000000111111111
10C0000001110000E0001
1000000C0000011100001
100C00000000C0000C001
111111111111111111111