111111111111
10000PEC0001
111111111111