111111111111111111111
100P00000C00000001111
111100000000111111111
1000000000000000E0001
1000000C0000011100001
100C0000000000000C001
111111111111111111111