11111111111111111111
1P1C0000000000000E01
10100000000000000001
10111111111111100001
10000000000000000001
10111111111111111001
100000000000000C1001
10000111111111111001
100001C0000000000001
10000111111111111101
11100000000000000101
10000000000000000101
10011111111111111101
10000000000000000001
10000000000000000001
11111111111111111111