111111111111
100000000001
10000PEC0001
111111110111