111111111111
100P00000001
11100C011111
100000000E01
111111111111