111111111111
100000000P01
11100C011111
100000000E01
111111111111