111111111111
100P00000001
11100E011111
10000000C001
111111111111